Alice Cooper - School's Out
Gustavo Lima - De Menina pra Mulher 
Pearl Jam - Evenflow
Pericles - Até que Durou
Marcos & Belutti - Tudo Indica
Henrique & Juliano - Volta por Baixo
Martinho da Vila - Canta, Canta Minha Gente
Sia - Let's Love
Marshmello - Too Much
Led Zeppelin - Stairway to Heaven
Jorge Aragão - Do fundo do nosso quintal
Rage Against the Machine - Bulls On Parade
Jorge & Mateus - Tijolão
Jason Derulo - Don't Cry For Me
Kiss - Rock and Roll All Night
Alcione - Vou Festejar
System of Down - Chop Suey
Alok - Alive(It Feels Like)
Matheus e Kauan - Litrão
Dream Theater - Pull me Under
Péricles - Melhor eu ir
Exaltasamba - Me Apaixonei Pela Pessoa Errada
Slipknot - Duality
Heart - Barracuda
Martinho da Vila - Disritmia
Metallica - One
Maiara & Maraisa - Aí Eu Bebo
Dilsinho - Misturados
Cartola - Alvorada
Rolling Stones - Paint It Black
Raça Negra - Cheia de Manias
Calvin Harris - Over Now
Megadeth - Holy Wars
Sorriso Maroto - Chave e Cadeado
Tiesto - The Business
Almir Guineto - Conselho